# Glossary in tab-separated format -*- coding: utf-8 -*-
gadgets	小工具	组件，配件。GMS中的DnD工具？
Trial	试用版	GMS2一个受限制的版本。
fixtures	支架	box2d物理引擎中的支架。
joints	节点	物理引擎中的连接的关节。
PrimitiveBuilder	图元构建器
Strip Image	长带图	依次带状排列的多帧图片，可以导入切割作为精灵使用
Tileset	图块集	图块设置，采取图块的集合。
Viewport	视口	视野中的画面实际描绘的区域或者平面。
tile set	图块集	tileset,tile set都是图块集的意思。
Tilemap	图块地图
Dock	停靠栏
target platform	目标平台	指gms2导出的项目运行的平台
Start Page	起始页	进入GMS2的开始页面
Create New GUID	创建新的 GUID
Enable Short Circuit Evaluations	启用短路求值
Login	登录
Logout	注销
Manage Account	管理账户
Rename	重命名
Resize	调整大小
colour picker	取色器
gadget	部件
joints	关节
mipmap	多级渐进纹理	一系列分辩率递减的纹理图
Pinch	捏合	手势  - 捏合，改变图像缩放比例
AudioGroup	音频组
YoYo Games helpdesk	YoYo游戏知识库
Next:	下一页：
Normalised Vectors	规格化向量
Matrix	矩阵
Back:	上一页：
Functions	函数
Syntax	语法
identity matrix	单位矩阵
build	构建
structure	结构
index	索引
index	编号
variable	变量
parameters	参数
function	函数
arguments	参数
coordinate	坐标
position	位置
vector	向量
orthographic	正交的
local	局部
local	本地
matrices	矩阵
projection	投影
assigned	赋予
assigned	分配
perspective	透视的
dimensions	维度
dimensions	标架
dimensions	尺度
view	视野
Array	数组
elements	元素
stack	栈
stack	堆栈
socket	套接字
port	端口
server	服务端
clients	客户端
string	字符串
read-only	只读
call	调用
Objects	物体
instances	实例
bracket	方括号
parenthesis	小括号
brace	大括号
merge	合并	用于git情境
macro	宏，宏常量
Health	健康值	统一用作健康值
cursor	光标	统一翻译为光标。
Addon	附加组件	add-ons，addon，附加组件，外接组件。
Chain	连接线	链，连接，连接线
Home Indicator	Home横条	苹果设备的术语
provisioning profile	预置描述文件	苹果设备应用开发的专用术语
Hinting	一种字体渲染微调的机制
Inspector	检查器、审查器	在 IDE 类环境中应该翻译为检查器或审查器，直译为检查员等
gamepad	手柄 游戏手柄
RMB	鼠标右键	Right Mouse Button
LMB	鼠标左键	Left Mouse Button
Set head position (in frames) of sequence instance ${sequenceelmid} to ${var}	将序列实例${sequenceelmid}的头部位置(以帧为单位)设置为${var}
Gutter	间隙
Gutter	间隙
